111111111111111111
10000000000C000001
10P1C0010000000101
10000000C010000E01
111111111111111111