11111111111111111
1C00000C011000001
1P0011000000C0001
100000110000000E1
11111111111111111