11111111111111111
10C00000011000001
10001100000C00001
100000110000C00E1
11111111111111111