11111111111111111
10000000011000001
1P001100000000001
100000110000000E1
11111111111111111