1111111111111111111111111111111111
10C0000001100000000000000
1P001100000C0000000000000000000001
100000110000C00E000000000000000001
1111111111111111111111111111111111