11111111111111111
10C00000011000001
1P001100000C00001
100000110000C0001
11111111111111111