111111111111111
100000000000001
10P1C0011000101
100C010000C0E01
111111111111111