1111111111111
100000C000001
10P1C00100101
100C010000E01
1111111111111