1111111111111
1000000000001
10P1C00100101
100C0100C0E01
1111111111111