11111111111111111
10C00000011000001
1P001100000C00001
10P000110000C00E1
11111111111111111